20
30
00010110011000001000
00000000000010000000
00000000010000000000
00000000000000000000
00001000000000100000
00010000000010100000
00010000000000000100
00000000000001011001
10000010000000000000
00100000000000000001
00000000000000000000
00000000000000100000
00001000000001000000
00101000000001000000
00000001000000000000
